1111111111111111111111111111111
1000000000000000000000000000001
1000000000000000011111111110001
1000000000000000010000000010001
1000000111111111110000000010001
1000000100000000000000000010001
1000000100000000000000011110001
1000000100000000000000010000001
1000000100000000011111110000001
1000000100000000010000000000001
1000000100000000010000000000001
1000000111110000010000000000001
1000000000010000010000000000001
1000000000010000011111111100001
1000001111110000000000000100001
1000001000000000000000000100001
1002001000000000000011111100001
1000001000000000011110000000001
1111111000000000010000030000001
1000000000000000010000000000001
1111111111111111111111111111111